%%%%%%%%%%
%        %
%  % % % %
%  %%%   %
%  %P% % %
%  % % % %
%        %   
%        %
%%%%%%%%%%