%%%%%%%%%%
%        %
%        %
%    P   %
%        %
% G      %
%%%%%%%%%%